************************************************************
******************************..........********************
***********................................................*
***********.*****.************..........***********.********
**..........*****.........********..********........********
**....*****.*************.********..********.***************
**....*****................................................*
**....*****.****.***.********.********************.*********
*****.*****.****.***............******************.*********
*****.*****.****.***.******........................*********
*****.*****.****.***.********.********************.*********
**..........****.***.***...........................*********
**.*************.***.***.*****.****.************************
**.*************.....***.*****.****.************************
**.*************.***.***.****....**.*********.........******
**...............***.***.****....**...........*******.******
**.*************.***.***.****..****.*********.*******.******
**.*************.***.***.****..****.*********.*******......*
**.......................****.......*********.........******
************************************************************